Circled	â“€â“â“¤â“¢â“â“šâ“ â“€â“˜â“¡â“˜â“â“
Circled (neg)	ğŸ…šğŸ…ğŸ…¤ğŸ…¢ğŸ…ğŸ…šğŸ… ğŸ…šğŸ…˜ğŸ…¡ğŸ…˜ğŸ…ğŸ…
Fullwidth	ï¼«ï½ï½•ï½“ï½ï½‹ï½ ï¼«ï½‰ï½’ï½‰ï½ï½
Math bold	ğŠğ¨ğ®ğ¬ğšğ¤ğš ğŠğ¢ğ«ğ¢ğ§ğ¨
Math bold Fraktur	ğ•¶ğ–”ğ–šğ–˜ğ–†ğ–ğ–† ğ•¶ğ–ğ–—ğ–ğ–“ğ–”
Math bold italic	ğ‘²ğ’ğ’–ğ’”ğ’‚ğ’Œğ’‚ ğ‘²ğ’Šğ’“ğ’Šğ’ğ’
Math bold script	ğ“šğ“¸ğ“¾ğ“¼ğ“ªğ“´ğ“ª ğ“šğ“²ğ“»ğ“²ğ“·ğ“¸
Math double-struck	ğ•‚ğ• ğ•¦ğ•¤ğ•’ğ•œğ•’ ğ•‚ğ•šğ•£ğ•šğ•Ÿğ• 
Math monospace	ğ™ºğš˜ğšğšœğšŠğš”ğšŠ ğ™ºğš’ğš›ğš’ğš—ğš˜
Math sans	ğ–ªğ—ˆğ—ğ—Œğ–ºğ—„ğ–º ğ–ªğ—‚ğ—‹ğ—‚ğ—‡ğ—ˆ
Math sans bold	ğ—ğ—¼ğ˜‚ğ˜€ğ—®ğ—¸ğ—® ğ—ğ—¶ğ—¿ğ—¶ğ—»ğ—¼
Math sans bold italic	ğ™†ğ™¤ğ™ªğ™¨ğ™–ğ™ ğ™– ğ™†ğ™ğ™§ğ™ğ™£ğ™¤
Math sans italic	ğ˜’ğ˜°ğ˜¶ğ˜´ğ˜¢ğ˜¬ğ˜¢ ğ˜’ğ˜ªğ˜³ğ˜ªğ˜¯ğ˜°
Parenthesized	â’¦â’ªâ’°â’®â’œâ’¦â’œ â’¦â’¤â’­â’¤â’©â’ª
Regional Indicator	ğŸ‡°ğŸ‡´ğŸ‡ºğŸ‡¸ğŸ‡¦ğŸ‡°ğŸ‡¦ ğŸ‡°ğŸ‡®ğŸ‡·ğŸ‡®ğŸ‡³ğŸ‡´
Squared	ğŸ„ºğŸ„¾ğŸ…„ğŸ…‚ğŸ„°ğŸ„ºğŸ„° ğŸ„ºğŸ„¸ğŸ…ğŸ„¸ğŸ„½ğŸ„¾
Squared (neg)	ğŸ…ºğŸ…¾ğŸ†„ğŸ†‚ğŸ…°ğŸ…ºğŸ…° ğŸ…ºğŸ…¸ğŸ†ğŸ…¸ğŸ…½ğŸ…¾
Tag	ó ‹ó ¯ó µó ³ó ¡ó «ó ¡ó € ó ‹ó ©ó ²ó ©ó ®ó ¯
A-cute pseudoalphabet	á¸°Å‘ÃºÅ›Ã¡á¸±Ã¡ á¸°Ã­Å•Ã­Å„Å‘
CJK+Thai pseudoalphabet	ã‚ºouä¸‚ï¾‘ã‚ºï¾‘ ã‚ºï¾‰å°ºï¾‰åˆ€o
Curvy 1 pseudoalphabet	á›•Ñ»àªªà¸£à¸„á›•à¸„ á›•Ù±É¼Ù±à¸Ñ»
Curvy 2 pseudoalphabet	ĞºÏƒÏ…Ñ•Î±ĞºÎ± ĞºÎ¹ÑÎ¹Î·Ïƒ
Curvy 3 pseudoalphabet	Ğºà¹à¸¢à¸£à¸„Ğºà¸„ Ğºà¹€Ğ³à¹€à¸ à¹
Faux Cyrillic pseudoalphabet	ĞŒĞ¾Ñ†Ñ•Ğ°ĞºĞ° ĞŒÑ–Ñ“Ñ–Ğ¸Ğ¾
Faux Ethiopic pseudoalphabet	áŒ•á‹áˆáŠáˆáŒ•áˆ áŒ•áŒá‹ªáŒáŠ­á‹
Math Fraktur pseudoalphabet	ğ”ğ”¬ğ”²ğ”°ğ”ğ”¨ğ” ğ”ğ”¦ğ”¯ğ”¦ğ”«ğ”¬
Rock Dots pseudoalphabet	á¸²Ã¶Ã¼á¹¡Ã¤á¸³Ã¤ á¸²Ã¯á¹›Ã¯á¹…Ã¶
Small Caps pseudoalphabet	á´‹á´á´œêœ±á´€á´‹á´€ á´‹ÉªÊ€ÉªÉ´á´
Stroked pseudoalphabet	ê€Ã¸áµ¾sÈºêÈº ê€É¨ÉÉ¨nÃ¸
Subscript pseudoalphabet	â‚–â‚’áµ¤â‚›â‚â‚–â‚ â‚–áµ¢áµ£áµ¢â‚™â‚’
Superscript pseudoalphabet	á´·áµ’áµ˜Ë¢áµƒáµáµƒ á´·â±Ê³â±â¿áµ’
Inverted pseudoalphabet	ê“˜onsÉÊÉ ê“˜Ä±É¹Ä±uo
Inverted pseudoalphabet (backwards)	ouÄ±É¹Ä±ê“˜ ÉÊÉsnoê“˜
Reversed pseudoalphabet	KoUê™…AkA Kiá´™iá´o
Reversed pseudoalphabet (backwards)	oá´iá´™iK AkAê™…UoK
